WWWWWWWWWWWWWWWW
W##############W
W####0#0#0#S###W
W####0#0#######W
W#0##000#######W
W#0########000#W
W#0##BBB###0#0#W
W#00#B#BB##00##W
W###BB#####00##W
W####000###0#0#W
W####0##0##0##0W
W####0##0######W
W####000#######W
WWWWWWWWWWWWWWWW